FFFFFFFFFFFFFFFFFFF
0000000000000000000
0WWWWWWWWWWWWW00000
0WFFFFFWFFFFFW00000
0WPFFFFWFFFFFW00000
0WFFFFF0FFFFFW00000
0WFFFFFWFFFFFW00000
0WFFFFFWFFFFFW00000
0WWFWWWWFFFFFW00000
0WFFFFFWWWEWWW00000
0WFFFFFWFFFFFW00000
0WFFFFFWFFFFFW00000
0WFFFFFFFFFFFWWWWW0
0WFFFFFWFFFFFW00000
0WWWWWWWWWWWWW00000
0000000000000000000
FFFFFFFFFFFFFFFFFFF