FFFFFFFFFFFFFFFFFFF
0000000000000000000
0WWWWWWWWWWWWWWWWW0
0WFFFFFWFFFFFWFFKW0
0WFFFFFWFFFFFFFFFW0
0WFFFFFFFFFFFWFFFW0
0WFFFFFWFFFFFWFFFW0
0WFFFFFWFFFFFWWWWW0
0WWFWWWWFFWFFW00000
0WFFFFFWWWEWWW00000
0WFFFFFWFFHFPW00000
0WFFFFFWFFFFFW00000
0WFFFFFFFFFFFWWWWW0
0WFFFFFWFFFFFW00000
0WWWWWWWWWWWWW00000
0000000000000000000
FFFFFFFFFFFFFFFFFFF