FFFFFFFFFFFFFFFFFFF
0000000000000000000
0000000000000000000
0000000000000000000
0000000000000000000
0000000000000000000
0000000000000000000
0000000000000000000
0000000000000000000
0WWWWWWWWWWWWWWWWW0
0WFFFFFFFFFFFFFFFW0
0WPFFFFFFFFFFFFFEW0
0WWWWWWWWWWWWWWWWW0
0000000000000000000
0000000000000000000
0000000000000000000
FFFFFFFFFFFFFFFFFFF